NO ./xpm/cat1.xpm
SO ./xpm/cat2.xpm
WE ./xpm/cat3.xpm
S ./xpm/cat.xpm
EA ./xpm/cat4.xpm
R   720 480



F 220,22,30

C 135,113,144



 1111111111111
1000000000001
1000000000001
100001100011111111111
100011000000000000001
111111111111111111111
1111111111111
1000000000001
1100011000011
1002000000001
10000W1111111
111111
