NO ./xpm/cat1.xpm
SO ./xpm/cat2.xpm
WE ./xpm/cat3.xpm
S ./xpm/cat.xpm
EA ./xpm/cat4.xpm
R   720 480



F 23,22,30

C 135,113,144



 1111111111111
1000000000001
1000000000001
1000011000111
1000000000001
1111111111111
1111111111111
1000000000001
1100011000011
1002000000001
100W001111111
111111
